@......===..
.#..#.......
..###....#..
...#.....#..
...=.#.#.#..
.....=====..
.==.........
...#..#.#...
....###.....
.........%..
............
............