@......===.
.#..#......
..###....#.
...#.....#.
...=.#.#.#.
.....=====.
.==........
...#..#.#..
....###....
.........%.
...........