@...........
..######....
............
.###..###...
..#...#..#..
..#...#..#..
..#...###...
............
..######....
.........%..
............
............