@...........
.===..===...
.=......=...
.=......=...
....##......
....##......
.=......=...
.=......=...
.===..===...
.........%..
............
............